55255e55555555555555
12555pb5551222522555
5225bp55255522522555
52555pb5555252522525
5555bp55255222252255
52555pb555b252252252
52222pppppp225225525
555555b55bpppppppppe
5555555555p555555555
555555555bpb55555555
5555555555pb55552255
555255555bpppp555555
525555bb55bbbpb55555
55555pppppppppb55555
5555bpb5b5b555525555
55255p55525555552255
52555pb55555b5555525
5555bpppppppppf55555
555225b55bb5b5555555
55255555555555522255
<S2>
<S1>
1
250