4444e14434444323444444444444442444444144
4445ppppppppppp2444444444441444444444444
5544244214b444p444424454444b5b4244444144
42344412312321pppppppppppppppppp44444444
4444444b44444444b45243b44544423p23324224
4544444414244443442544444411444p44424444
4444444444444444442445444444444pb4444444
4444444444443244445414pppppppppp24431444
4454444312443423445b44pb434244b214524443
4324444444pppppppppppppppppppppppppppppe
4444444444p54444b44444p43244444444444414
4134234444p54454b44414p44442441444425444
4444454444p52635312554444444343444144445
424244144bp44454423444324135234444445213
4444444444p544444444444444b4214244544124
4444444444pb4444b44444444444444253441244
4444444233pppppppppppppppppf414432441441
44155442344414144324b2455444144454544244
4423444544124455445554414244455444444444
4444444444444444444444444444444444444444
4444444444444444424142344444454441444444
4444544243444414244444455542423444414444
<W5,S2,W3>
<S3,W5,B1>
4
500
