4444e14434444323444444444444442444444144
4445p44444344442444444444441444444444444
5544p44214244414444244544444544244444144
4532p4444444444444ppppp44444444444444444
4444p4444444444444pb43p44544424414424224
4544p4441424444344p544p44411444444434444
444bp4444444444444p445p44444444444444444
4444p4444444324444p414p45441442434441444
4454pb43124434234bp432p44342444414544443
4324ppppppppppppppp423p44444444444444444
4444444444444444b4444bp43244444444444414
4134234444454454444414p44442441444425444
4444454444424441444414pb4444343444144445
4242441444244454423444ppppppppppb4445213
44444444444444444444444444b421bp44544124
4444444444444444444444444444444p53441244
4444444233333444444444414444414p32441441
4415544234441414432442455444144pb4544244
4423444544124455445554414244455p44444444
4444444444444444444444444444444f44444444
4444444444444444424142344444454441444444
4444544243444414244444455542423444414444
<S2>
<S1>
1
500
