4444e14434444323444444444444442444444144
4445p44444344442444444444441444444444444
5544p44214b4441444424454444b5b4244444144
4532pppppppppppppppppppppppppppp44444444
4444444b44444444b45243b4454442bp14424224
4544444414244443442544444411444p44434444
4444444444444444442445444444444pb4444444
4444444444443244445414445441442p24441444
445444431244342344534444434244bp14544443
4324444444214414434323pppppppppp44444444
4444444444454444344444p43244444444444414
4134234444354454b44414p44442441444425444
4444454444ppppppppppppp44444343444144445
424244144bp44454423444324135234444445213
4444444444p544444444444444b4214244544124
4444444444pb4444b44444444444444253441244
4444444233pppppppppppppppppf414432441441
44155442344414144324b2455444144454544244
4423444544124455445554414244455444444444
4444444444444444444444444444444444444444
4444444444444444424142344444454441444444
4444544243444414244444455542423444414444
<S2>
<S1>
1
500
