5555e15535555323555555545555552555555154
5555ppppppppppp2555555555551555554555555
5555255215b555p555525555555b5b5255555155
52355512312321pppppppppppppppppp55545555
5554555b55555555b55253b55555523p23325225
5554555515255553552555555511555p55525555
5544555554455554552555555545555pb5555545
5555555555553255555515pppppppppp25531555
5555555312553523555b55pb535255b215525553
5325555555pppppppppppppppppppppppppppppe
5555555555p55555b55555553255555555555515
5135235555p55555b55515555552551455525555
5555555555p52535312555555545353555155555
525255155bp55555523555325135235555555213
5555555555p55555555555555555215255555125
5555555555pb5555b55555555555555253551255
5555555233pppppppppppppppppf515532551551
55155552355515155325b2555555155555555255
5523555554125555555555515255555555555555
5555455544555555555555555554455545555555
5555555544555555525152355555555551555555
5545555253555515255555555552523555515455
<W5,S2,W3>
<S3,W5,E2>
<B1>
4
500
