4444414434444323444444444444442444444144
4445444444344442444444444441444444444444
5544444214b4441444424454444b5b4244444144
453244pppppppppppppppppppppppppp44444444
444444pb44444444b45243b4454442bp14424224
454444p414244443442544444411444p44434444
444444p444444444442445444444444pb4444444
epppppp444443244445414445441442p24441444
445444431244342344b34444434244bp14544443
4324444444pppppppppppppppppppppp44444444
4444444444pb4444b44444443244444444444414
4134234444p54b54444414ppppp244144ppppppe
4444454444ppppppp44414p4b4p434344p1b4445
424244144bp44454p23b44p241p523b44p445213
4444444444p54444ppppppp444pppppppp454412
4444444444pb4444b44444444444444253441244
4444444233ppppppppppppppppp4414432441441
44155442344414144324b24554p4144454544244
4423444544124b554455544b42p4455444444444
44444fppppppppppppppppppppp4444444444444
4444444444b44444424b42344444454441444444
4444544243444414244444455542423444414444
<S5>
<W3>
<E1>
2
500
